################################
#..............................#
#..............................#
#..............................#
#..##########################..#
#..............................#
#..............................#
#..##########################..#
#..............................#
#..............................#
#..##########################..#
#..............................#
#..............................#
#..##########################..#
#..............................#
#..............................#
#..##########################..#
#..............................#
#..............................#
#..##########################..#
#..............................#
#..............................#
#..............................#
################################