################################
#x............................x#
#..............................#
#....#........#................#
#.........................##...#
#....................#....##...#
#.....####.....#...............#
#..............#...............#
#..............#...............#
#..............#...#...........#
#..................#.....#.....#
#........#.........#...........#
#........#.........##..........#
#........#.....................#
#.............#..........#.....#
#....#........#................#
#....#........#...........#....#
#.............#.....#..........#
#.............#................#
#.....#########................#
#...................#######....#
#..............................#
#x............................x#
################################