################################
#x............................x#
#..............................#
#...###..................###...#
#...###..................###...#
#...###..................###...#
#.............####.............#
#.............####.............#
#.............####.............#
#.............####.............#
#...###..................###...#
#...###..................###...#
#...###..................###...#
#.............####.............#
#.............####.............#
#.............####.............#
#.............####.............#
#...###..................###...#
#...###..................###...#
#...###..................###...#
#..............................#
#..............................#
#x............................x#
################################